1.322788767337916283e-01
7.332186744222429775e-02
1.075711679652216896e-01
1.500961756646347900e-01
1.502196419053231091e-01
1.537805839202351088e-01
9.028219378957223762e-02
1.779334228142296359e-01
2.269839810982482442e-01
1.442142068435298408e-01
1.825034439157480481e-01
6.511871919373175832e-02
1.222740710780232665e-01
1.732203200439514923e-01
1.712752784145939733e-01
1.265713409446090065e-01
1.424765914149919155e-01
9.785333207150911927e-02
1.321752015063487884e-01
1.643337653641860074e-01
1.408683113554952682e-01
1.448502316682353797e-01
9.586257436183022451e-02
1.337968450492512951e-01
1.789970611138060053e-01
6.132720903060243089e-02
1.635103999170475497e-01
1.216418528921254932e-01
1.947845965656899436e-01
1.404008115312623262e-01
7.788767486046870026e-02
1.554351550593538744e-01
1.037695882740482245e-01
1.201275556659884419e-01
8.838188250795285528e-02
1.665689660876464584e-01
1.661505609753038126e-01
1.070366998081965781e-01
1.356730241666458947e-01
1.408621327365190135e-01
1.761121832202265369e-01
1.251418462629220463e-01
1.427393535199321939e-01
1.434462894840042579e-01
5.753178427438982584e-02
1.594334179251034878e-01
1.707545285649340050e-01
1.267337045552964225e-01
1.109982368919375656e-01
1.316299624311370042e-01
1.060869450357613264e-01
1.578806047923073108e-01
1.560173153065373963e-01
1.459905950868900515e-01
1.330461400446729947e-01
1.453891490364373207e-01
1.611978530767277928e-01
9.471186376800694307e-02
1.164425491199870821e-01
8.725868182689644481e-02
1.220485922050281030e-01
1.708242898775907681e-01
1.359848131354377265e-01
6.211331447971084330e-02
1.596922316959303867e-01
2.045666395047278929e-01
1.277739384644320242e-01
1.284075112294554011e-01
1.740338270164139278e-01
1.938677213175708236e-01
1.000072615028352457e-01
2.080218029968875504e-01
1.545171003647952124e-01
1.407043547024126595e-01
1.353860282462789055e-01
1.651314197357027225e-01
2.028111786108366954e-01
1.412423019620127340e-01
1.009811911508868704e-01
1.202721377842372874e-01
1.830857990880578046e-01
1.070749968603597613e-01
1.564132500581748575e-01
1.492166634183200169e-01
1.868801328175270227e-01
1.651311579948153141e-01
1.446119782911642337e-01
5.967779189266576856e-02
1.248977045641798678e-01
2.180669681302074558e-01
2.000170644439662193e-01
1.481499302306270305e-01
2.050725902318542571e-01
1.348529430351507741e-01
1.192230044996372001e-01
1.137814884345719063e-01
1.903732795390897792e-01
1.055098131044353293e-01
1.402532972391714872e-01
6.942797624774912912e-02
1.092786728996249790e-01
1.176667629236929635e-01
9.665689160344620445e-02
1.810784376816969854e-01
1.096871917478097480e-01
1.285343899771586862e-01
1.702748910451014341e-01
1.277340294897882644e-01
1.141391541141166116e-01
1.183280138476092563e-01
1.114246604547754343e-01
2.122996980575179438e-01
1.024531723899512470e-01
1.513631347449174158e-01
1.882722526137057539e-01
1.209731275587381805e-01
1.789473274504406464e-01
1.100749518947970740e-01
1.328193121250167696e-01
9.450660652388774563e-02
6.911525647676830530e-02
1.485984635975190482e-01
1.387419392663206685e-01
1.493871422971158602e-01
1.205936890372886483e-01
1.541922298017128212e-01
1.776346263542715187e-01
1.968929065046713112e-01
8.404217964226866344e-02
9.422359025987039893e-02
1.399837954385459715e-01
2.220546264952883986e-01
1.097787116200249491e-01
1.380559375049566773e-01
6.363534428290897049e-02
1.404921736738763416e-01
1.783874809858052857e-01
1.648992667815701307e-01
1.453435166501111930e-01
1.024551750598692995e-01
1.205898860986533150e-01
5.825237355119970706e-02
1.183609640589671219e-01
1.614488588071399111e-01
1.561919607567982260e-01
1.161142947361118311e-01
1.785039953473093188e-01
1.817553937377459627e-01
1.306756556702143857e-01
1.834580572773552576e-01
1.010630918341907380e-01
1.011400981579640423e-01
1.874228089142870313e-01
1.795297101425266384e-01
1.190842128810917500e-01
1.689288355575352119e-01
9.352267413494896875e-02
1.165179678093526405e-01
1.714295737489718308e-01
8.901396598272787175e-02
1.335022778949098710e-01
1.479428737269037342e-01
1.307410889116674413e-01
1.556330362649015198e-01
1.539200332441105767e-01
9.961305073099237239e-02
1.454642715303943179e-01
1.441404662740970177e-01
7.853801575254806822e-02
8.149319390759382498e-02
1.283182456108220293e-01
1.082924718268361286e-01
1.518860287952789601e-01
1.791564296901033693e-01
1.590911803244281220e-01
1.596642766670095803e-01
9.953642800002314439e-02
1.650633578121105949e-01
1.533541608252395327e-01
8.322389131505403270e-02
1.297901784505200440e-01
1.785756875646682673e-01
1.323429809035279181e-01
8.896442625724097775e-02
1.569027374543087716e-01
1.668971351884278309e-01
1.457315008067927575e-01
1.109322680878611633e-01
1.398913635882399753e-01
1.357956470280450301e-01
9.944863160102995758e-02
1.070790493828471246e-01
1.085328411091160405e-01
9.600064033287310228e-02
1.660690351538788856e-01
1.230606824838859220e-01
1.611844407494385789e-01
1.964600211946508079e-01
1.694550937597593676e-01
1.210795366758155439e-01
