1.772319780436306391e-01
1.611732518003363979e-01
8.525208913366685848e-02
8.199613258522303605e-02
1.320119083173617591e-01
1.247123597304009429e-01
2.527111553673649924e-02
1.120487221381157583e-01
1.350485334450919339e-01
1.925732229677445673e-01
8.393725177686359173e-02
1.316943605850197929e-01
1.429542695234462535e-01
1.372102915219016728e-01
5.707643339008765943e-02
9.291824932268950843e-02
1.455528420954366742e-01
1.570942896765610830e-01
1.089379581307131778e-01
1.860193923180297471e-01
1.303767410407400129e-01
7.782733868468093286e-02
1.061138701520008554e-01
1.549074192362131785e-01
1.306092631494658596e-01
4.125940264306916794e-02
9.549320258420254670e-02
1.553142836432880036e-01
1.429049701294426711e-01
8.159970186585087382e-02
1.104194507052317781e-01
9.665207047996696166e-02
5.818392489657141231e-02
7.425041253346946479e-02
6.826812404569242154e-02
1.555726277076728004e-01
9.409039192789256378e-02
1.084928021837744810e-01
1.026288351016367700e-01
1.967159402032942483e-01
8.028670512871026455e-02
9.673490503876423785e-02
1.303259536383647998e-01
1.272594116913463580e-01
1.198999544546495016e-01
1.977646400801348348e-01
8.894949463381013333e-02
1.258524504541341238e-01
1.100452466041206140e-01
1.756402897242552164e-01
1.241182871289496781e-01
7.599188529816731930e-02
1.067837953585272157e-02
1.297886370563057501e-01
1.527217361274120500e-01
1.292899016460985206e-01
1.069873762952545521e-01
1.745783060255519381e-01
1.249428098269848159e-01
1.740481372292983220e-01
9.627400027565669038e-02
9.209624382324634040e-02
9.103827505568604095e-02
1.118987431899711588e-01
1.022158927803081402e-01
1.534812501313465583e-01
9.709245467091708048e-02
1.128684116240023932e-01
8.897895542983480510e-02
1.013138680593286545e-01
1.725087224589059165e-01
1.399324147211261360e-01
1.270279919066821805e-01
1.520202711305640442e-01
6.844642616978485750e-02
1.561328981984382025e-01
1.049315510404516399e-01
2.381686813553164361e-01
1.554806981622522954e-01
1.224343883142946648e-01
1.259557227904247734e-01
1.905438847068956498e-01
2.825170363344101099e-02
1.689644828513630070e-01
6.901813320687558151e-02
1.196016966744502114e-01
9.173412064633482133e-02
1.402006242020681637e-01
1.082290940184574141e-01
9.431972930049394022e-02
6.728545717036418794e-02
1.099377835574604084e-01
1.181315033745801990e-01
6.584518892387183908e-02
7.523972116216970374e-02
1.167773210367117204e-01
2.159300690689578139e-01
1.398673172879418836e-01
6.990876300838354263e-02
1.750856651285676857e-01
6.819833172349064332e-02
1.647453058787299585e-01
1.318235324654961904e-01
1.422114785836832151e-01
9.371064214618812782e-02
1.804933652850312098e-01
1.158712071327455823e-01
9.227303511571774419e-02
9.004291040115486311e-02
9.958615691473274301e-02
1.786354434429161808e-01
6.869485054278622049e-02
6.041783438713403676e-02
1.594293897365542667e-01
8.645010559941376793e-02
1.368410891671257290e-01
7.660326875945874803e-02
1.483602926482269213e-01
1.019818868950934793e-01
1.446526036215960431e-01
1.239328264978228206e-01
1.294936757165170982e-01
1.915980533499705984e-01
1.527409713155556681e-01
8.920031511878037667e-02
1.297620670032244294e-01
1.320527211514649357e-01
3.257313185389375948e-02
9.557799726757158776e-02
1.582055727752116614e-01
7.995994598664704633e-02
1.283464125396576172e-01
1.097249278244883525e-01
1.084126041576340821e-01
9.102238218378964907e-02
1.538416119587504571e-01
1.195883363059538768e-01
8.460747799635209843e-02
1.487121118661339503e-01
1.219326418061569411e-01
1.584000714108443064e-01
1.236333051757954465e-01
1.053446633511800901e-01
9.801767907515944456e-02
1.388415800478354778e-01
5.137123662227061766e-02
9.812403268054063765e-02
1.401003789941711875e-01
1.188817643961627563e-01
1.473983414819540483e-01
1.435758247267764354e-01
1.502478885200078107e-01
1.964907058566310039e-01
1.366024796059941981e-01
1.785010483513614077e-01
1.480729933045532853e-01
1.173040749586470172e-01
8.195146284663065717e-02
1.308663707332377579e-01
1.084615715592537194e-01
1.320949774018189415e-01
1.244739744017275412e-01
8.595145429713683949e-02
8.315106358383693441e-02
1.321575898971844021e-01
1.328904521132549532e-01
1.066352009579360077e-01
8.369277871087826837e-02
1.447674120073300930e-01
1.303027172384850496e-01
1.162426511930441247e-01
1.618831050708716135e-01
7.753119819699666460e-02
1.633170866818691447e-01
1.481802887690573944e-01
1.928437445795628813e-01
1.962292389607896426e-01
1.215663871987425343e-01
8.074005578667196870e-02
1.937609417776225973e-01
8.506757303474797582e-02
1.522761226024452463e-01
1.461497522639586266e-01
7.140403509539193505e-02
1.193102833347407382e-01
9.870820766635257648e-02
1.453749969810382847e-01
5.394601750054662387e-02
1.234949039392897047e-01
1.061847839849971303e-01
1.030024358425433856e-01
1.415939524128545512e-01
9.457676643645281100e-02
1.092351853739269157e-01
1.052926842185385736e-01
1.430667068229330430e-01
1.647382109206120826e-01
1.007109149443577573e-01
1.512930760706516775e-01
1.403226012228944997e-01
