1.518289483046361410e-01
1.339484350693512793e-01
1.899917694660011869e-01
1.337755801138300338e-01
1.524257501569048767e-01
1.350486963512946004e-01
2.068766259823835163e-01
2.176612632038142925e-01
2.931934946853861912e-01
1.390301846718924317e-01
2.163347559749177751e-01
2.310405790446515006e-01
1.670222687169943820e-01
1.540345562883924657e-01
1.579013964693062877e-01
5.459377119970312831e-02
1.360480733169298073e-01
1.481713421089637106e-01
1.444442371983416240e-01
1.657088462691893860e-01
1.638095012946042539e-01
2.257994298875200256e-01
2.507739241150724885e-01
1.214690547970150858e-01
1.104603696413207908e-01
1.564354597098672195e-01
9.010871109440733717e-02
1.362647019564495465e-01
1.840414986018723276e-01
2.122056992164960409e-01
1.006893783663019154e-01
1.705697586813131883e-01
1.599647892076468958e-01
2.720356661426160394e-01
9.789419525298279079e-02
1.371549511822433010e-01
1.396718225979436123e-01
1.980366051641845038e-01
1.423183865115548452e-01
6.660707593844125696e-02
2.318248132690603203e-01
1.090608965764445493e-01
2.077767629584547637e-01
1.698394641049357778e-01
2.425455627755687404e-01
1.818113338991483585e-01
2.378963513837020483e-01
2.990194222829672954e-01
2.534476776025603728e-01
1.012694676068803118e-01
9.119200182881348482e-02
2.225064467308465188e-01
1.300604876286757805e-01
1.611664358906544359e-01
2.521765475373093368e-01
1.821044211042720240e-01
1.201142596980846189e-01
2.403448972056747568e-01
1.531151526530638574e-01
1.724183700062510427e-01
1.360001032888780992e-01
1.588166494674472518e-01
1.188977581568911035e-01
2.158742315385355215e-01
1.833532605652479774e-01
1.498584408573430948e-01
7.977650505945589610e-02
1.644697471294316593e-01
1.167503760768101723e-01
2.268087604535689583e-01
1.810844748809949389e-01
1.510694580870796389e-01
1.459295847324020290e-01
1.743183949529823751e-01
1.463783660208282933e-01
1.514233406844874841e-01
2.218231755922631387e-01
2.283580029405679890e-01
1.632273406469286758e-01
1.780143698040535793e-01
2.359883833762764782e-01
1.546833227763419194e-01
3.552352610221721219e-01
1.030066002754612686e-01
1.328815043201557466e-01
1.468497983834403664e-01
2.616203792261579952e-01
1.398939976983422651e-01
1.101569051434491270e-01
2.422196709827102168e-01
1.185344139969309873e-01
2.410345646915049711e-01
2.214048142311308420e-01
1.466994251929595872e-01
1.405620416714152554e-01
3.207940922464188049e-01
1.292281747872759956e-01
1.177661646834732290e-01
1.961289813099679202e-01
5.126052306180616663e-02
2.070679488669124046e-01
2.242041065351735585e-01
1.050571629986701144e-01
2.186848949275328191e-01
2.394783960259126154e-01
5.693855276834720869e-02
5.897836624802567373e-02
1.852202346295938884e-01
2.010753788364902372e-01
1.270205351063230514e-01
9.347897198754451242e-02
1.151045610481120224e-01
2.431596978440440926e-01
2.611273535361356979e-01
1.859626896948347041e-01
2.164034329409963986e-01
1.363882447378949592e-01
2.072277477257281619e-01
3.721411625056610800e-02
1.644277890931487573e-01
1.310136104273305624e-01
8.484539931932751078e-02
1.844908220163993806e-01
1.165710691227094531e-01
1.800934328234792547e-01
1.698875408136225063e-01
2.438445208286055266e-01
1.636463177595508522e-01
3.738965319733645876e-01
1.829897198536316050e-01
2.395461696769460025e-01
1.011194955190404671e-01
7.261382237407815188e-02
8.009014685695060864e-02
1.808557013675016756e-01
1.144346925710512664e-01
1.157182902083911946e-01
2.628584416356707920e-01
1.539611379462381413e-01
9.712019572002203449e-02
9.135255662084595940e-02
1.489586303703404058e-01
1.649812847362565615e-01
1.440756905392051312e-01
2.841201231934688543e-01
1.838821473398513651e-01
1.797378914973125907e-01
2.110854690475831019e-01
1.575229074353976799e-01
1.220697321073695163e-01
1.588111622072334583e-01
1.089065527524338273e-01
1.754040849842862237e-01
1.456266194791812907e-01
1.834630455725319575e-01
1.496260258779954777e-01
1.626625809263474165e-01
1.558584402240598410e-01
1.025078967965709770e-01
1.356691707844986106e-01
2.532544645641253145e-01
9.031392027274989798e-02
1.385529025766874256e-01
9.940636327680371642e-02
2.203998644100771953e-01
1.275406288437953006e-01
2.278633636451268818e-01
2.960684222779752517e-01
1.928227392347254265e-01
1.471551299728414697e-01
9.693739594823766459e-02
1.487940234384177995e-01
1.088043944548269110e-01
8.459985452523161031e-02
8.756472167157416941e-02
1.888522846294191648e-01
2.406238685882075012e-01
2.878234598712007819e-01
1.761184571173522451e-01
2.013123162219286888e-01
1.669874486385095891e-01
1.368147590110371237e-01
3.107841023387641899e-01
9.626026513725258194e-02
2.254361161741359476e-01
9.895817032306959693e-02
1.772230995863219860e-01
1.227396092219934787e-01
2.038324700623983243e-01
1.256722081773450905e-01
2.207311739174452059e-01
2.229486452951459363e-01
2.304836437670141347e-01
8.364083009120894252e-02
2.725732768280154095e-01
3.919264841704809404e-02
1.048162598998861189e-01
1.249085101102084261e-01
1.100428988225621296e-01
3.437170685357938127e-01
